##########
#........#
#........#
#..@.....#
#........#
#........#
##########
