##########
#........#
#........#
#..@.....#
#........#
#.....s..#
##########
