#############
#@....#M....#
#.k.#####...#
#q......Q...#
#...q...B...#
#############